Mr. Brightside - The Killers - Genres: alternative rock, dance rock, modern rock, permanent wave, rock
Smells Like Teen Spirit - Nirvana - Genres: grunge, permanent wave, rock
Seven Nation Army - The White Stripes - Genres: alternative rock, blues rock, detroit rock, garage rock, modern blues rock, permanent wave, punk blues, rock
The Less I Know the Better - Tame Impala - Genres: australian psych, modern rock, neo-psychedelic, rock
Creep - Radiohead - Genres: alternative rock, art rock, melancholia, oxford indie, permanent wave, rock
Karma Police - Radiohead - Genres: alternative rock, art rock, melancholia, oxford indie, permanent wave, rock
Can't Feel My Face - The Weeknd - Genres: canadian contemporary r&b, canadian pop, pop
Come as You Are - Nirvana - Genres: grunge, permanent wave, rock
Feel Good Inc. - Gorillaz - Genres: alternative hip hop, modern rock, rock
Take on Me - a-ha - Genres: album rock, classic rock, mellow gold, rock, singer-songwriter, soft rock, yacht rock
Africa - Toto - Genres: album rock, classic rock, hard rock, mellow gold, rock, soft rock, yacht rock
Everlong - Foo Fighters - Genres: alternative metal, alternative rock, modern rock, permanent wave, post-grunge, rock
Everybody Wants to Rule the World - Tears for Fears - Genres: new romantic, new wave, new wave pop, permanent wave, rock, sophisti-pop, synthpop
Float On - Modest Mouse - Genres: alternative rock, chamber pop, indie rock, indietronica, modern rock, washington indie
Take Me Out - Franz Ferdinand - Genres: alternative rock, dance rock, indie rock, modern rock, rock, scottish rock
Midnight City - M83 - Genres: french shoegaze, french synthpop, indietronica, metropopolis, neo-synthpop
Under the Bridge - Red Hot Chili Peppers - Genres: alternative rock, funk metal, funk rock, permanent wave, rock
Electric Feel - MGMT - Genres: alternative rock, indie rock, indietronica, modern rock, rock
Fortunate Son - Creedence Clearwater Revival - Genres: album rock, classic rock, country rock, mellow gold, rock, southern rock, swamp rock
The Middle - Jimmy Eat World - Genres: alternative metal, alternative rock, emo, modern power pop, modern rock, neon pop punk, pop punk, pop rock, post-grunge, punk, rock
All the Small Things - blink-182 - Genres: alternative metal, modern rock, pop punk, punk, rock, socal pop punk
Hotline Bling - Drake - Genres: canadian hip hop, canadian pop, hip hop, pop rap, rap
Don't Stop Believin' - Journey - Genres: album rock, classic rock, hard rock, mellow gold, rock, soft rock
Say It Ain't So - Weezer - Genres: alternative rock, modern power pop, modern rock, permanent wave, rock
Losing My Religion - R.E.M. - Genres: modern folk rock
Riptide - Vance Joy - Genres: folk-pop, modern rock
Zombie - The Cranberries - Genres: irish rock, pop rock, rock
Kids - MGMT - Genres: alternative rock, indie rock, indietronica, modern rock, rock
Buddy Holly - Weezer - Genres: alternative rock, modern power pop, modern rock, permanent wave, rock
Basket Case - Green Day - Genres: modern rock, permanent wave, punk, rock
All I Want for Christmas Is You - Mariah Carey - Genres: dance pop, pop, urban contemporary
September - Earth, Wind & Fire - Genres: disco, funk, jazz funk, motown, soul
Do I Wanna Know? - Arctic Monkeys - Genres: garage rock, modern rock, permanent wave, rock, sheffield indie
Pumped Up Kicks - Foster the People - Genres: indietronica, modern alternative rock, modern rock, rock
Black Hole Sun - Soundgarden - Genres: alternative metal, alternative rock, classic rock, grunge, hard rock, nu metal, rock
Last Nite - The Strokes - Genres: alternative rock, garage rock, modern rock, permanent wave, rock
HUMBLE. - Kendrick Lamar - Genres: conscious hip hop, hip hop, rap, west coast rap
Island in the Sun - Weezer - Genres: alternative rock, modern power pop, modern rock, permanent wave, rock
Skinny Love - Bon Iver - Genres: chamber pop, eau claire indie, indie folk, melancholia, modern rock
Hello - Adele - Genres: clap and tap
Redbone - Childish Gambino - Genres: atl hip hop, hip hop, rap
High and Dry - Radiohead - Genres: alternative rock, art rock, melancholia, oxford indie, permanent wave, rock
Two Weeks - Grizzly Bear - Genres: art pop, baroque pop, brooklyn indie, indie rock, neo-synthpop, new weird america
Killing in the Name - Rage Against the Machine - Genres: alternative metal, alternative rock, conscious hip hop, funk metal, hard rock, nu metal, political hip hop, post-grunge, rap metal, rap rock, rock
Fade Into You - Mazzy Star - Genres: dream pop, melancholia, shoegaze, slowcore
The Hills - The Weeknd - Genres: canadian contemporary r&b, canadian pop, pop
Royals - Lorde - Genres: art pop, metropopolis, nz pop, pop
Gimme Shelter - The Rolling Stones - Genres: album rock, british invasion, classic rock, rock
Semi-Charmed Life - Third Eye Blind - Genres: alternative metal, alternative rock, pop rock, post-grunge
Yellow - Coldplay - Genres: permanent wave, pop
