Smells Like Teen Spirit - Nirvana - Genres: grunge, permanent wave, rock
Creep - Radiohead - Genres: alternative rock, art rock, melancholia, oxford indie, permanent wave, rock
Seven Nation Army - The White Stripes - Genres: alternative rock, blues rock, detroit rock, garage rock, modern blues rock, permanent wave, punk blues, rock
Teardrop - Massive Attack - Genres: downtempo, electronica, trip hop
Karma Police - Radiohead - Genres: alternative rock, art rock, melancholia, oxford indie, permanent wave, rock
Come as You Are - Nirvana - Genres: grunge, permanent wave, rock
No Surprises - Radiohead - Genres: alternative rock, art rock, melancholia, oxford indie, permanent wave, rock
Wonderwall - Oasis - Genres: beatlesque, britpop, madchester, permanent wave, rock
Glory Box - Portishead - Genres: alternative rock, art pop, dark pop, electronica, laboratorio, trip hop
Walk on the Wild Side - Lou Reed - Genres: classic rock, glam rock, permanent wave, rock, singer-songwriter
Sultans of Swing - Dire Straits - Genres: album rock, classic rock, mellow gold, rock
Take Me Out - Franz Ferdinand - Genres: alternative rock, dance rock, indie rock, modern rock, rock, scottish rock
Midnight City - M83 - Genres: french shoegaze, french synthpop, indietronica, metropopolis, neo-synthpop
Nightcall - Kavinsky - Genres: filter house
Take on Me - a-ha - Genres: album rock, classic rock, mellow gold, rock, singer-songwriter, soft rock, yacht rock
The Less I Know the Better - Tame Impala - Genres: australian psych, modern rock, neo-psychedelic, rock
Where Is My Mind? - Pixies - Genres: alternative rock, boston rock, permanent wave, rock
Under the Bridge - Red Hot Chili Peppers - Genres: alternative rock, funk metal, funk rock, permanent wave, rock
Losing My Religion - R.E.M. - Genres: modern folk rock
Do I Wanna Know? - Arctic Monkeys - Genres: garage rock, modern rock, permanent wave, rock, sheffield indie
Come - Jain - Genres: desi pop, hindi indie, indian indie, indian singer-songwriter
Killing in the Name - Rage Against the Machine - Genres: alternative metal, alternative rock, conscious hip hop, funk metal, hard rock, nu metal, political hip hop, post-grunge, rap metal, rap rock, rock
Feel Good Inc. - Gorillaz - Genres: alternative hip hop, modern rock, rock
Boys Don't Cry - The Cure - Genres: new wave, permanent wave, rock, uk post-punk
Intro - The xx - Genres: downtempo, dream pop, indietronica
The Look - Metronomy - Genres: alternative dance, electronica, french indie pop, indietronica, neo-synthpop, new rave, socal pop punk
Bitter Sweet Symphony - The Verve - Genres: britpop, permanent wave, rock, shoegaze
Fortunate Son - Creedence Clearwater Revival - Genres: album rock, classic rock, country rock, mellow gold, rock, southern rock, swamp rock
Californication - Red Hot Chili Peppers - Genres: alternative rock, funk metal, funk rock, permanent wave, rock
Africa - Toto - Genres: album rock, classic rock, hard rock, mellow gold, rock, soft rock, yacht rock
Shape of You - Ed Sheeran - Genres: pop, singer-songwriter pop, uk pop
Pumped Up Kicks - Foster the People - Genres: indietronica, modern alternative rock, modern rock, rock
Highway to Hell - AC/DC - Genres: australian rock, hard rock, rock
Zombie - The Cranberries - Genres: irish rock, pop rock, rock
Billie Jean - Michael Jackson - Genres: r&b, soul
Kids - MGMT - Genres: alternative rock, indie rock, indietronica, modern rock, rock
Banquet - Bloc Party - Genres: alternative dance, alternative rock, dance-punk, indie rock, indietronica, modern rock, neo-synthpop, new rave
Riptide - Vance Joy - Genres: folk-pop, modern rock
Cheap Thrills - Sia - Genres: 
Feeling Good - Nina Simone - Genres: jazz blues, neo soul, soul, soul jazz, torch song, vocal jazz
Back to Black - Amy Winehouse - Genres: british soul, neo soul
Sunset Lover - Petit biscuit - Genres: new french touch
Paper Planes - M.I.A. - Genres: escape room, indietronica, new rave
September - Earth, Wind & Fire - Genres: disco, funk, jazz funk, motown, soul
Sweet Home Alabama - Lynyrd Skynyrd - Genres: album rock, classic rock, hard rock, rock, southern rock
For What It's Worth - Buffalo Springfield - Genres: album rock, blues rock, classic rock, country rock, folk, folk rock, mellow gold, psychedelic rock, rock, soft rock, southern rock
One More Time - Daft Punk - Genres: electro, filter house, rock
Every Breath You Take - The Police - Genres: album rock, classic rock, permanent wave, rock
Chandelier - Sia - Genres: 
Instant Crush (feat. Julian Casablancas) - Daft Punk - Genres: electro, filter house, rock
