Mr. Brightside - The Killers
Smells Like Teen Spirit - Nirvana
Seven Nation Army - The White Stripes
The Less I Know the Better - Tame Impala
Creep - Radiohead
Karma Police - Radiohead
Can't Feel My Face - The Weeknd
Come as You Are - Nirvana
Feel Good Inc. - Gorillaz
Take on Me - a-ha
Africa - Toto
Everlong - Foo Fighters
Everybody Wants to Rule the World - Tears for Fears
Float On - Modest Mouse
Take Me Out - Franz Ferdinand
Midnight City - M83
Under the Bridge - Red Hot Chili Peppers
Electric Feel - MGMT
Fortunate Son - Creedence Clearwater Revival
The Middle - Jimmy Eat World
All the Small Things - blink-182
Hotline Bling - Drake
Don't Stop Believin' - Journey
Say It Ain't So - Weezer
Losing My Religion - R.E.M.
Riptide - Vance Joy
Kids - MGMT
Zombie - The Cranberries
Buddy Holly - Weezer
Basket Case - Green Day
All I Want for Christmas Is You - Mariah Carey
September - Earth, Wind & Fire
Do I Wanna Know? - Arctic Monkeys
Pumped Up Kicks - Foster the People
Black Hole Sun - Soundgarden
Last Nite - The Strokes
HUMBLE. - Kendrick Lamar
Island in the Sun - Weezer
Skinny Love - Bon Iver
Hello - Adele
Redbone - Childish Gambino
Two Weeks - Grizzly Bear
High and Dry - Radiohead
Killing in the Name - Rage Against the Machine
Fade Into You - Mazzy Star
The Hills - The Weeknd
Royals - Lorde
Gimme Shelter - The Rolling Stones
Semi-Charmed Life - Third Eye Blind
Intro - The xx
