Smells Like Teen Spirit - Nirvana
Creep - Radiohead
Seven Nation Army - The White Stripes
Teardrop - Massive Attack
Karma Police - Radiohead
Come as You Are - Nirvana
No Surprises - Radiohead
Wonderwall - Oasis
Glory Box - Portishead
Walk on the Wild Side - Lou Reed
Sultans of Swing - Dire Straits
Take Me Out - Franz Ferdinand
Midnight City - M83
Nightcall - Kavinsky
Take on Me - a-ha
Where Is My Mind? - Pixies
The Less I Know the Better - Tame Impala
Under the Bridge - Red Hot Chili Peppers
Losing My Religion - R.E.M.
Do I Wanna Know? - Arctic Monkeys
Come - Jain
Feel Good Inc. - Gorillaz
Killing in the Name - Rage Against the Machine
Boys Don't Cry - The Cure
Intro - The xx
The Look - Metronomy
Bitter Sweet Symphony - The Verve
Fortunate Son - Creedence Clearwater Revival
Californication - Red Hot Chili Peppers
Africa - Toto
Shape of You - Ed Sheeran
Pumped Up Kicks - Foster the People
Highway to Hell - AC/DC
Zombie - The Cranberries
Billie Jean - Michael Jackson
Kids - MGMT
Banquet - Bloc Party
Riptide - Vance Joy
Cheap Thrills - Sia
Feeling Good - Nina Simone
Back to Black - Amy Winehouse
Sunset Lover - Petit biscuit
Paper Planes - M.I.A.
September - Earth, Wind & Fire
Sweet Home Alabama - Lynyrd Skynyrd
For What It's Worth - Buffalo Springfield
One More Time - Daft Punk
Every Breath You Take - The Police
Instant Crush (feat. Julian Casablancas) - Daft Punk
Chandelier - Sia
