Smells Like Teen Spirit - Nirvana
Africa - Toto
Mr. Brightside - The Killers
Come as You Are - Nirvana
In the End - Linkin Park
Seven Nation Army - The White Stripes
Don't Stop Believin' - Journey
Chop Suey! - System of a Down
Take on Me - a-ha
Californication - Red Hot Chili Peppers
Under the Bridge - Red Hot Chili Peppers
All I Want for Christmas Is You - Mariah Carey
Numb - Linkin Park
Sex on Fire - Kings of Leon
All the Small Things - blink-182
Creep - Radiohead
Sultans of Swing - Dire Straits
Killing in the Name - Rage Against the Machine
Fortunate Son - Creedence Clearwater Revival
Basket Case - Green Day
Hello - Adele
Everlong - Foo Fighters
Losing My Religion - R.E.M.
No One Knows - Queens of the Stone Age
Take Me Out - Franz Ferdinand
Last Resort - Papa Roach
Paranoid - Black Sabbath
Oft Gefragt - AnnenMayKantereit
Tainted Love - Soft Cell
Toxicity - System of a Down
Feel Good Inc. - Gorillaz
Enter Sandman - Metallica
Can't Stop - Red Hot Chili Peppers
Teardrop - Massive Attack
The Pretender - Foo Fighters
Intro - The xx
Wonderwall - Oasis
Nothing Else Matters - Metallica
Zombie - The Cranberries
Boys Don't Cry - The Cure
The Passenger - Iggy Pop
Where Is My Mind? - Pixies
Banquet - Bloc Party
The Kids Aren't Alright - The Offspring
Stressed Out - Twenty One Pilots
All Along the Watchtower - Jimi Hendrix
Sweet Child o' Mine - Guns N' Roses
Kryptonite - 3 Doors Down
Bitter Sweet Symphony - The Verve
Shape of You - Ed Sheeran
