Holocene - Bon Iver
Heart-Shaped Box - Nirvana
Like a Rolling Stone - Bob Dylan
Trains - Porcupine Tree
For What It's Worth - Buffalo Springfield
Drive - Incubus
Sunshine of Your Love - Cream
Take Me Out - Franz Ferdinand
Cocaine - Eric Clapton
In My Place - Coldplay
Lose Yourself to Dance (feat. Pharrell Williams) - Daft Punk
Dani California - Red Hot Chili Peppers
Brain Damage - Pink Floyd
I'm Yours - Jason Mraz
A Horse With No Name - America
Breezeblocks - alt-J
Ho Hey - The Lumineers
(Don't Fear) The Reaper - Blue Öyster Cult
Heartbeats - José González
Otherside - Red Hot Chili Peppers
New Rules - Dua Lipa
Good Riddance (Time of Your Life) - Green Day
Speed of Sound - Coldplay
Let It Happen - Tame Impala
Budapest - George Ezra
Here Without You - 3 Doors Down
Pompeii - Bastille
Feels Like We Only Go Backwards - Tame Impala
Cornfield Chase - Hans Zimmer
Don't Panic - Coldplay
Hey There Delilah - Plain White T's
Here Comes The Sun - Remastered 2009 - The Beatles
Trouble - Coldplay
Master of Puppets - Metallica
Shut Up and Dance - Walk the Moon
With or Without You - U2
Time - Hans Zimmer
Crazy - Gnarls Barkley
Lonely Boy - The Black Keys
Watermelon Sugar - Harry Styles
Toxicity - System of a Down
The Unforgiven - Metallica
We Don't Talk Anymore (feat. Selena Gomez) - Charlie Puth
Without Me - Eminem
Skinny Love - Bon Iver
Roobaroo - A.R. Rahman
Dancing Queen - ABBA
Titanium (feat. Sia) - David Guetta
Arriving Somewhere but Not Here - Porcupine Tree
Fade Into You - Mazzy Star
