Mr. Brightside - The Killers
Float On - Modest Mouse
The Less I Know the Better - Tame Impala
Smells Like Teen Spirit - Nirvana
Everybody Wants to Rule the World - Tears for Fears
Electric Feel - MGMT
Everlong - Foo Fighters
The Middle - Jimmy Eat World
Seven Nation Army - The White Stripes
Creep - Radiohead
Africa - Toto
Feel Good Inc. - Gorillaz
Can't Feel My Face - The Weeknd
Take on Me - a-ha
Midnight City - M83
Come as You Are - Nirvana
Karma Police - Radiohead
Say It Ain't So - Weezer
HUMBLE. - Kendrick Lamar
Fortunate Son - Creedence Clearwater Revival
Buddy Holly - Weezer
September - Earth, Wind & Fire
Fade Into You - Mazzy Star
Maps - Yeah Yeah Yeahs
All the Small Things - blink-182
Semi-Charmed Life - Third Eye Blind
Under the Bridge - Red Hot Chili Peppers
Two Weeks - Grizzly Bear
Redbone - Childish Gambino
Hotline Bling - Drake
Take Me Out - Franz Ferdinand
Black Hole Sun - Soundgarden
Basket Case - Green Day
Intro - The xx
Loser - Beck
Santeria - Sublime
Landslide - Fleetwood Mac
All I Want for Christmas Is You - Mariah Carey
Island in the Sun - Weezer
Just Like Heaven - The Cure
Kids - MGMT
Last Nite - The Strokes
Don't Stop Believin' - Journey
Alright - Kendrick Lamar
The Hills - The Weeknd
Space Song - Beach House
Pumped Up Kicks - Foster the People
Hello - Adele
A-Punk - Vampire Weekend
1901 - Phoenix
